.S..E#...T
#G##..###.
#E###.###E
#.....###.
###T#E...G